# Map 2: Rectangular grid test (15x8)
# Icon 1 = Shoreline (easy passing)
# Icon 2 = Grassland (easy passing)

1,0 1,0 1,0 1,0 1,0 1,0 1,0 1,0 1,0 1,0 1,0 1,0 1,0 1,0 1,0
1,0 2,0 2,0 2,0 2,0 2,0 2,0 2,0 2,0 2,0 2,0 2,0 2,0 2,0 1,0
1,0 2,0 2,0 2,0 2,0 2,0 2,0 2,0 2,0 2,0 2,0 2,0 2,0 2,0 1,0
1,0 2,0 2,0 2,0 2,0 2,0 2,0 3,2 3,2 2,0 2,0 2,0 2,0 2,0 1,0
1,0 2,0 2,0 2,0 2,0 2,0 2,0 3,2 3,2 2,0 2,0 2,0 2,0 2,0 1,0
1,0 2,0 2,0 2,0 2,0 2,0 2,0 2,0 2,0 2,0 2,0 2,0 2,0 2,0 1,0
1,0 2,0 2,0 2,0 2,0 2,0 2,0 2,0 2,0 2,0 2,0 2,0 2,0 2,0 1,0
1,0 1,0 1,0 1,0 1,0 1,0 1,0 1,0 1,0 1,0 1,0 1,0 1,0 1,0 1,0
